Rank,Nation,Gold,Silver,Bronze,Total
1.0,Brazil,21,9,12,42
2.0,United States,9,3,6,18
3.0,China,1,9,8,18
4.0,Australia,1,1,1,3
4.0,Netherlands,1,1,1,3
6.0,Estonia,1,0,0,1
7.0,Germany,0,5,1,6
8.0,Russia,0,2,3,5
9.0,Argentina,0,2,0,2
10.0,Switzerland,0,1,1,2
11.0,Norway,0,1,0,1
12.0,Austria,0,0,1,1
